...###....
..##.#.###
.##..###..
.#........
....@..#..
.##..###..
..#..#....
.##.##.#.#
.#......##
.#.....##.
.#######..